-12
12
-6
9
000000000000000000000000
000000001111111000000000
000000001111111000000000
000000001111111000000000
000000001111111000000000
001000001111111000000100
001000001110111000000100
001000001110111000000100
001000000000000000000100
111000000000000000000111
111000000000000000000111
111000000000000010000111
111000000000000000000111
111000000000000000000111
111000000000000000000111
100000000000000000000001
